#########
#S#.....#
#.#.###.#
#.#...#.#
#.###.#.#
#.....#G#
#########
