###########
#S....#...#
#.###.#.#G#
#...#.#.#.#
###.#.#.#.#
#...#...#.#
#.#######.#
#.........#
###########
