###########
#S....#...#
#.###.#.#.#
#...#...#.#
###.###.#.#
#...#...#.#
#.#####.#.#
#.......#G#
###########
