#############
#S....#.....#
#.###.#.###.#
#...#.#...#.#
###.#.###.#.#
#...#.....#.#
#.#######.#.#
#.......#.#.#
#.#####.#.#.#
#.....#...#G#
#############
