###############
#S....#.......#
#.###.#.#####.#
#...#.#.....#.#
###.#.#####.#.#
#...#.....#.#.#
#.#######.#.#.#
#.......#.#.#.#
#######.#.#.#.#
#.....#.#...#.#
#.###.#.#####.#
#...#........G#
###############
