###############
#S#.......#...#
#.#.#####.#.#.#
#.#.....#.#.#.#
#.#####.#.#.#.#
#.....#.#.#.#.#
#####.#.#.#.#.#
#...#.#.#.#.#.#
#.#.#.#.#.#.#.#
#.#...#...#.#.#
#.#########.#.#
#...........#G#
###############
