#################
#S#.#.........#.#
#.#.#.#####.#.#.#
#.....#...#.#...#
#.###.#.#.#.###.#
#...#...#.#.#...#
###.#.#.###.#.#.#
#.#.#.#.....#...#
#.#.###.#######.#
#.#.#...#.....#.#
#.#.#.###.#.#.#.#
#...#...#...#...#
#.#####.#.#...#.#
#.....#.#.#.#.#.#
#.#.#.#.#.#.###.#
#...#...#.#....G#
#################
