#################
#S..............#
###############.#
#.............#.#
#.###########.#.#
#.#.........#.#.#
#.#.#######.#.#.#
#.#.#.....#.#.#.#
#.#.#.###.#.#.#.#
#.#.#.#...#.#.#.#
#.#.#.#.###.#.#.#
#.#.#.#.....#.#.#
#.#.#.#######.#.#
#.#.#.........#.#
#.#.###########.#
#..............G#
#################
