#################
#S#.............#
#.#.###########.#
#.#.#.........#.#
#.#.#.#######.#.#
#.#.#.#.....#.#.#
#.#.#.#.###.#.#.#
#.#.#.#.#...#.#.#
#.#.#.#.#.###.#.#
#.#.#.#.#.....#.#
#.#.#.#.#######.#
#.#.#.#.........#
#.#.#.#########.#
#...#...........#
###.###########.#
#..............G#
#################
